1111111111111
1000000000P11
1000001011111
100011E00C001
1111111111111

