111111111111111111111111111
1000000000P1001100000001111
100000101111C01100000001111
100011100C00001111111111111
110C00000000001011111111111
1000C000CC00100001111111111
111111100111111000001111111
111111110111111111100001111
1111111100000C11111110000E1
111111111111111111111111111