1111111111111
1000000000P01
1000011111001
100011E00C001
1111111111111

