111111111111111111111111111
100000111111111000000111111
100110011111CC0011100111111
10011100C111100111100111111
100C11100000001111100111111
100C1111CC00111111100111111
100111111111111111100111111
100111111111111111100111111
1P01111111111111111000CE111
111111111111111111111111111